0001100101
1100100010
0000100111
0001000011
0110101110
1100000010
1111000123